%%%%%%%
%P    %
%  .  %
%  .  %
%  . G%
%%%%%%%
