%%%%%%%%%%
%P ..  . %
%.   .  G%
% . .  ..%
%%%%%%%%%%