%%%%%%%%
%P   . %
%.     %
%%%%%%%%